%%%%%%%%
%      %
%      %
%HHHH  %
%   DH %
% HHH  %
%   P R%
%%%%%%%%