%%%%%%%%
% H H H%
%      %
%HHHH  %
%  PDH %
% HHHR %
%      %
%%%%%%%%