%%%%%%%%
%P     %
%      %
%HHHH  %
%   DH %
% HHHR %
%      %
%%%%%%%%