%%%%%%%%
%      %
%      %
%HHHH  %
%   D  %
% HHH  %
%   P R%
%%%%%%%%